NO ./textures/blue.xpm
SO ./textures/brick.xpm
WE ./textures/grey.xpm
EA ./textures/wood.xpm

F 0,136,0
C 0,255,255

1111111111
1000000001
10S0000001
1001101001
1001001001
1001001001
1001011001
1000000001
1000000001
1111111111