NO ./textures/bluestone.xpm
SO ./textures/purplestone.xpm
WE ./textures/mossy.xpm
EA ./textures/eagle.xpm
F 0,136,0
C 0,255,255
1111
11N1
1111