NO ./textures/bluestone.xpm
SO ./textures/purplestone.xpm
WE ./textures/mossy.xpm
EA ./textures/eagle.xpm

F 0,136,0
C 0,255,255

		1111111111111111111111111
		1000000000110001111110001
		1011000001110001	10001
		1001000000000001	10001
111111111011000001110001111110001
100000000011000001110111111111111
11110111111111011100000010001
11110111111111011101010010001
11000000110101011100000010001
10000000S00000001100000010001
10000000000000001101010000001
1100000111010101111101111000111
11110111 1110101 101111010001
11111111 1111111 111111111111